sequence	amino_acid
LFTTFDVCYQESSLITAGEHNHYGPSETHVVTTC	pro
SWNLFDAFALTTVFMLGGEMNAYGPTESSVMATY	phe
LVFAFDASVWDGTLITAGSVNGYGPTESTVCATL	phe
YWASFDLTVTSTKLIVGGEFNEYGPTETVVGCMI	asn
HWMTFDASVWELQMFCGGEINLYGPTETTIDATY	gln
NWKLFDAFVLSTTGTLGGEVNEYGPTESSVVATW	tyr
LHTGFDAMTFEGWLIVGGEWNGYGPTENTTFSTC	val
VAWAFDVSTGDREAILGADINSYGVTEACIDTSY	orn
CWRFFDGFVASAYGTLGGENNEYGPTENSVVTTI	leu
LNSGFDAVTFEGFLYVGGEHNIYGPTENTTFSTF	ile
VNTSFDGSVFDGFILFGGEIHVYGPTESTVYATY	ile
TDISFDLSVYDGNSLLSGDISLGGATEGSIWSIY	cys
LWHAFDAFVWEPFLLTGGDVNNYGPTENTVVATS	leu
LGLAFDASVKQADMIVGGDTNVYGPTECCVDAAS	glu
YAFVFDAFSEEPSCISGGDYNSYGPTEATVCATY	lys
ATWAFDVFAGDRESIMGSDINSYGVTEASVDSGY	orn
VNTSFDGSVFDGFIFLGGEIHVYGPTESTVYATY	ile
LAVAFDASAFEPTLVSAGSINAYGPTETTVCATA	phe
YWFSFDLGYTSSKLVLGGEMNHYGPTETTIGSVF	asp
YAVSADLGNTTAKIILGGEFNHYGPTETTIGVMV	asp
YWASFDLTVTSTKLIVGGEYNEYGPTETVVGCMI	asn
LFFAFDASVWEMTLITAGSINAYGPTETSICATI	phe
LFFAFDASVWEMTLITAGSINAYGPTETTICATT	phe
LFTTFDVCYQESSFITAGEHNHYGPSETHVVTTY	pro
LNTGFDALTFEGWLIVGGDWNGYGPTENTTFSTC	val
VAWAFDVSAGDREAIVGSDVNSYGVTEACIDSSY	orn
FGMTFDASVWQWHFFAGGEIHGYGPTEATVDAAF	glu
AAWAFDVFSGDRESILGSDINSYGVTEATIDSSF	orn
TWRFFDGCVTSTIITFAGEANEYGPTENSVATTI	tyr
LHQHFDFSVWEGNQIFGGEINMYGITETTVHVTF	thr
LFEAFDVCYQESFLIAAGEHNHYGPSETHVVSTY	pro
FSLTFDASIWEWHFFSGGETNSYGPTEATVEAAF	gln
TWRFFDGFITSTIITLAGEANEYGPTENSVATTV	tyr
LALTFDVSVSEMSMIVGGEFNCYGPTEATVCSTM	trp
LWHAFDASVWEPFLLTGGDVNQYGPTENTVVATA	leu
MAYTFDVSVSEQSMEVGGDFNCYGPTEATVGTVI	trp
FWATFDLSVYEANTNLCGEFNLYGPTEDTVYSTH	gly
LKTSFDAATFEGWLLVGGDINGYGPTENTTFTCC	val
LNTSFDAATFEGWLLVGGDINGYGPTENTTFTCC	val
LWHAFDASVWEPFLLTGGDANQYGPTENAVVATA	leu
LWHAFDAAVWEPFLLTGGDVNQYGPTENAVVATA	leu
FWATFDLSVYEVNTNLAGEFNLYGPSEDTTYSTY	ala
LETSFDAATFEGWLLVGGDINGYGPTENTTFTCC	val
VGMTFDISVAEGNFLACGEENIYGPTEATIYASR	gly
RWMTFDVSVWEWHFFASGEINLYGPTEATIDVSY	ser
YWASFDLTVTSTKLIVGGDFNEYGPTETVVGCMI	asn
SWKYFDAFILNGSTVVGGENNEYGPTENSVVSTF	tyr
YWASFDLTVTSTKLIVGGECNEYGPTETVVGCML	asn
LGLAFDASVQQADGLIGGETNVYGPTETCVDASL	gln
LYEAFDVCYQESFLITAGEHNHYGPSETHVVTMC	pro
FWIAFDLSVMDPVSLFCGEYNTYGPTEATVAVTQ	ala
FWAAFDLSVMDPTSLFCGEMNTYGPTEATVAVTG	ala
YWMSHDPIQRDTHLFFVGDVNMYGTTETQRAVSY	aad
YTFSFDILVEEPTTISGGEANGYGPSETTVAATF	glu
NGHH--HGISCRYGMFGGSISHYGSTETLMMSTR	aad
TAISPDNLVLSPLLYFGGAITALGSTETSIIPSI	aad
FWMPFDLSVMYPTSYFDGEINAYGPTEATVALSA	ala
FWMAFDLSIFSPISIFCGEYNTYGPTEATGAISS	ala
FWMAFDLSVMDTTSLFCGEYNLYGPTETTVAVSY	ala
YWMSHDPIQRDTHLFFVGDVNMYGTTETQRSVSF	aad
YWVAFDNSILDSFWLFCGEANLYGPTEITDVCSF	glu
NEILHDLGIGPHAAMNGAEVPCYGMAEVTLCASA	phe
YWMSHDPIQRDTHLFFVGDVNMYGTTETQRSVSY	aad
RWMTFDVSVWELHFYCSGEHNLYGPTEASIDVSA	phe
FWMAFDLSVMAPVSFFCGEYNTYGPTEATVAVTS	ala
FWAAFDLSVMDPTSLFCGEMNTYGPTEATVAVTS	ala
YWMSHDPIQRDTHLFFVGDVNMYGTTETQRAVSF	aad
FWIAFDLSVMDPTSMFCGEFNTYGPTETTVAVTS	ala
FWLAFDLSVYEGVSLFCGELNTYGPTEATVATTI	ala
IAWAFDVCSGDREFICGSDINSYGTTETTIDSTY	glu
LWYAFDMGMFDPASVVGGELNGYGPSEATCATHL	ala
FWLIFDVSLFEMVSVFCGETNTYGPTECTVAVTS	ala
FWTAFDLSVMDPTSLFCGEMNTYGPTEATVAVTG	ala
FWMSHDPIQRDTHLFFVGDINMYGTTETQRAVSY	aad
NSIIFTTTGHISSGIMGGACSGFGMTELCGLMYK	aad
QLLP-----FADFGTSAGAWTPYGATECLPVAAI	phe
FWMAFDLSVMDPTSLFCGEYNLYGPTETTVAVSY	ala
FWIAFDLSVTSPVSVFIGEINGYGPTEATVAVSI	ala
TDISFDLSVYDGNSLVSGDIALGGATEASIWSNY	glu
FAAAFDVAAEEPDLIIGGEINAYGPTETTVEATV	aad
LATHFDFSVWEGNQIFGGEVNMYGITETTVHVTY	thr
AAWAFDVFSGDREFIVGSDINSYGVTEATIDSSY	val
TDISFDLSVYDGNSMMSGDISLGGATEASIWSIF	glu
FICIFDFSFEEPYCIVGGELNTYGPTETTITALW	phe
HAIPCDTFIESPNIMVGGELNAYGALETTLTATV	orn
LETSFDASTFEGWLLAGGDINGYGPTESTTFTCC	phe
LETAFDASTFEGWLLAGGDINGYGPTENTTFTCC	phe
SARSFDSSVAGWLSIVAGEFNEYGPTEGTVWSSV	phe
YGISADLGNTGAKIILGGEFNHYGPTEATVGVTT	phe
YWCSFDLTITSSKIIIGGEVNEYGPTETVVGCCI	glu
YWCSFDLTITSSKLIIGGEVNEYGPTETVVGCCI	phe
NVTLHDMGIGGQGGFNGAEYPCYGMAEATLMVSG	phe
QWRIFDPSVWQWALTCGGEYNCYGPTEASIDTTF	phe
FGVSWDALTLEPFLMFGGEIHVYGPSECTVFTSS	asp
LAWGFDLSIGETFLTVGGEFNCYGPTESTVNAAL	orn
FWMAFDLSVTSPVSVFVGEINGYGPTEATVAVSI	ala
YASSADLGNTTGKIVLGGECNHYGPTETTVGILF	phe
YWNPFDLSVMDPVSLFCGEYNTYGPTETTVAVTG	ala
FWMAFDLSVMDPTSLFCGEFNTYGPTEATVAITS	ala
TQTTHDMSVFDASSAQGGDFSLGGPTETTIWSIW	glu
SAHAFDVSVFEFELLTIGEYGMYGPTEATIHCTA	aad
NTLCFDVSVFEFSLVTAGEYQGYGPCETTNICTV	cys
AAFAFDVSVLEWDLITGGEYNGYGPTEVTIGCTM	val
NFLV---FIWERLMWFNGELNCYSACETHEIACG	aad
YWMSHDPIQRDTHLFFVGDINMYGTTETQRAVSY	aad
SAHAFDAAIQEAGLVLFGELNGYGPTECSIFSSV	aad
GGHGFDITIQESGLTLFGEINVYGPSECTIHSVC	cys
SGHAFDVSIQESGLVLFGELSSYGPSECSMHSTC	val
SPRAFDVSIDSLGIGLGGEIIGYGPCECTIGCTV	phe
SCIAWDVSIGEGWLLSVGEINGWGPCEASILSTI	phe
YAFSFDIFVEEASGISGGDYNTYGPSETTVCASY	orn
KWMTFSPSLWEGGVSCSGEFNDYGSTENAVGYSE	glu
RWMTFIDHLQEGIAVLSGELNLYGTTEVSGDCTY	phe
HVASFDGFVEQPDLQATGELNSYGPTETVVTAVT	phe
SARAFDISVAQALAIVGGDFNEYGPTEATIFSTA	phe
LGSHFDFSVWEGNQIFGGEVNMYGITETTVHVTY	thr
YGVSADLGHTTGKIVLGGEINHYGPTETTVGILT	phe
FWMPFDLSVMSPVSLFCGEFNTYGPTEATVAMTQ	ala
FWMPFDLSNMYPVSLFCGEFNTYGPTEAAVAITS	ala
FWLAFDLSVMSPVSLFCGEYNTYGPTEATVAISA	ala
FWMPFDLSNMYPVGLFCGEFNTYGPTETTVAVSG	ala
LFFAFDASVWEMTLITAGSVNAYGPTETSICATI	phe
YFASFDLTITTAKLVVGGEYNEYGPTEATVGCMI	ala
FWEAFDLSVMSPVSLFCGEFNTYGPTETTVAVTQ	ala
FWMAFDLSVMDPVSMFCGEFNTYGPTEATVAVTQ	ala
FWMPFDLSVMDPVSLFCGEFNTYGPTETTVAVTQ	ala
FWVPFDLSNMYPVGMFCGEFNTYGPTETTVAISG	ala
FWTAFDLSVFSPVSLFCGEYNTYGPTEATVAISS	ala
YWNPFDLSVMDPVSLFCGEYNTYGPTEATVAVTG	ala
FWMPFDLSVMDPVSLFCGEYNTYGPTEATVAVSS	ala
FWMAFDLSVMAPVSFFCGEYNTYGPTEATVAVTG	ala
FWEAFDLSVMSPVSLFCGEFNTYGPTEATVAVTQ	ala
YWMSHDPVQRDTHLFFVGDVNMYGTTETQRAVSY	aad
FWIAFDLSVTSPVSVFVGEINGYGPTEATVAVSI	ala
FTFSFDAFVFEVFIYFGGEVHVYGPTETTVFCLK	glu
FWMPFDLSNMFPVGLFCGEFNTYGPTEATVAVSG	ala
YWLAFDMAVSVAKLILGGEYNEYGPTEATVAVSV	phe
FWMPFDLSVSQPVSLFIGEINGYGPTEATVGISH	ala
NWRYFDPSVWAWGALSGGEANLYGPTEATIDATV	aad
CAFTFDISLMELQALCGGEWNLYGPTETTIWSTA	phe
RWATFDVSVWELHFLCSGEHNLYGPTEAAIDVTS	phe
LWFTFDPSVEDGNFIFGGESNHYGPSETTVDCLT	phe
YAATFDLTQTAIKCIVGGEINEYGPTEATVGCCI	phe
INPCFDVYLFEGIILIGGEINCYGPTESTIMSLI	phe
LGLSFDASVQQPDCMIGGESNAYGPTECCVQSSS	phe
HGSTFDVGVHEVHAISAGEYNCYGPTETTVYVSH	phe
HMMTWDIVLEEPDLLVGTEFNAYAQTETTITATD	phe
YWATFDATITSLKTVIGGEFNEYGPTETVVGCCV	phe
LSQAFVAMTIEMMLLLGGEFNAYGSTETSSMVTA	phe
FAQAFDTSVSDPDVIVGGEINSYGPTETTVTATN	aad
FVQAFDTSVSDPDMIVGGEINSYGPTETTVIATT	cys
FAQAFDTSVSDPDLIVGGEINTYGPTETTVIATH	val
LSMTFDIAGLELQAISGGEWNLYGPTETTIWSTA	phe
YAYSYIAAIRDIGWCFSGSVNQYGPTEATASCTY	ala
YAYSYIAAIRDLGWCFSGSVNQYGPTEATASCTY	ala
FAELFDASCEELSTILGGEWNTYGPTEATVVACA	phe
LWMAFDLSMYEAVSLFCGELNTYGPTEATVATTW	ala
SEWLYSAQLYPHSIISVGNYEYYGSSEMGFVTVL	glu
FWIAFDLSVMDPTSMFCGEFNTYGPTEATVAVTS	ala
FAELFDASCEELSTIFGGEWNTYGPTEATVVACG	phe
FWIPFDLSVTTPVSIFIGEINGYGPTEATVGVSV	ala
FWMPFDLSVMDPVSFFCGEYNTYGPTEATVAVTG	ala
FAVTFDIAVLELQALVGGEWNMYGPTETTVWSTC	phe
FWMAFDLSVMDPVSLFCGEFNTYGPTEATVAVTH	ala
YWMPFDLSVMDPVSLFCGEFNTYGPTETCVAVTQ	ala
FWATFDLSVFEVNTNLAGEFNLYGPSEDTTYSTF	orn
LSMTFDLSVPDLQAICGGEWNMYGPTETTVWSTV	phe
YVAAFSITFFESHASTGGDHVIYGCSEVSCMACS	phe
RWMTFVDSVWEGVLVTSGELNLYGSSEVSADVTC	orn
YYIFFDLSVHDVFSLFCGEENLYGPTETTIAITH	ala
SDLSFEPFVRQMNGILVGELNEYGFTESAFVTAL	aad
LSLSFDHFVEQDSGDCVGEINGYGPTEVSITTHK	cys
LALSFDFSVEQLSGTAAGEYNAYGVTETTVYNII	val
SDLSFEPFVRQMHAILVGELNEYGFTESAFVTAL	aad
LSLSFDFSLEQLSGTAAGENNAYGITETTVYNII	val
LSLSFDHFVEQDSGDCVGEINGYGPTEISITTHK	cys
LALSFDFSIEQLSGTAAGEYNAYGITETTVYNIV	val
SDLAFEPHLRQINALLVGEVNEYAFTEAAFVTAV	aad
LSLSFDHFVEQDSGDAIGEINGYGPTEISITSHK	cys
FQLAFDFSVEQLSGLVAGELNAYGTTETTVYNTV	val
FWMPFDLSVMYPTSYFDGEVNAYGPTEATVALSA	ala
RWGTFDVSVPEADFEVAGEFNLYGPTEAAVEVTS	asp
LWLSFDLSQRSMHCLFGGELHQYGVAECTDVASS	phe
NDLT---FIHGVLSACGGAVPLWGCSETGIASIH	phe
MGRFWDGSLLKWVATLAGESNEYGPTETTVSCLA	phe
VAQAFDASVFEWVLVVAGEFNAYGPTEATIMSNA	phe
LEIAFDTALVEALSLVGGERNAYGPTETTCSVTL	phe
YWMSHDPIQRDTHLFFVGDVNM-------LWSLS	aad
YWMSHDPVQRDTHLFFVGDINMYGTTETQRAVSY	aad
LWMAFDLSMYEGVSLFCGELNTYGPTEATVATTL	ala
TDIAFDLSVYDGNSLWSGDFSLGGATEASIWSIE	glu
TAISFDLSVYDGNSLLSGDHALGGATEAGIWSNV	glu
HAIQFDGAHEGSYVTVGGEVNGYGPTETVITPTL	phe
GSVLFDAGLSQTTGANTGGYLMYGLTEA-FRSTY	phe
GSVLFDAGFSQTTAANTGGFLMYGLTEA-FRSTY	phe
LWHAFDASFHEAII-------------------V	asp
HAISSDTTIESPNLMVGGELNAYGSIATTFTATV	asp
LETSFDASTFEGWLLAGGDINGYGPTENTTFTCC	orn
LQTAFDASTFEGWLLAGGDINGYGPTENTTFTCC	phe
RWMTFDISVWEWHFMFSGEANLYGPTEASIDVTC	phe
HAIAFDVAAEEPNLVVGSERNAYGPTEATITATI	orn
YWCSFDATITSSKIIIGGEINEYGPTETVVGCCV	phe
RWMTFDISVWEWHFVFSGEANLYGPTEASIDVTA	phe
RWMTFDVSVWEWHFICSGEHNLYGPTEAAIDVTF	phe
HYLMHDYGVEGVQAGNAAEAPAYGLAENTLLVST	phe
LNTAFDAATFEGFLLFGGELHVYGPTENTTFTSW	orn
FWVAFDLSLIPAVSVFIGELNSYGPTEATIATTV	ala
YWMSHDPIQRDTHLFFVGD---------LTCTAH	aad
NHFSFDPSVVEVQAALGGEFNIYGITEVSSWATF	aad
FWMAFDLSIFSPISILCGEYNTYGPTEATGAISS	ala
LWHAFDVAAQESYAAQAGEHNHYGPAETHVMTGI	pro
VPLAFDAALWELTLVVAGETNAYGPTEAAVCTTI	phe
YDHWFDAAWQPADTALGGEFNCYGPTETTVEAVV	lys
LWHTFDVAAQEAYAAQAGEHNHYGPAETHVMTGT	pro
TAQAFDAAVWESALIVAGDVNAYGLTETTVCATM	phe
LWHTFDFSVQESFALQGGEHNVYGPAETHAVTTH	pip
LFEAFDVCYQESVSITAGEHNHYGPSETHVVSAY	pro
TWRFFDGFLTSTIITLAGEANEYGPTENSVATTA	tyr
FGMTFDASVWQWHFFAGGEVHGYGPTEATVDAAF	glu
LNSSFDVVTFEGWLIIGGEWNGYGPTENTTFSTC	val
LDPSFDASLFETYLLTGGDRNMYGPTEATMCATW	leu
LAHAFDTIVSEMKAVAAGEINAYGPTETTICATV	bht
YHCSFDLTITATKALLGGEVNEYGPTEATVGCVE	asn
LEPAFDISLFEVHLLTGGDRHLYGPTEATLCATW	hpg
LDPAFDASLVEVHLLTGGDRQLYGPTEITLCATW	hpg
LAHSFDAIVSEMTVLTGGEIQAYGPTETTICSTM	bht
LGLAFDASVQQTDGLVGGETNVYGPTETCVDASS	gln
TNTSFDAFMFDGMILFGGELHMYGPSESTVFTTY	leu
LWHAFDASVWEPFLLTGGDVNNYGPTENTVVATS	leu
LNAGFDASTFEGWLIIGGDWNGYGPTENTTFSTC	val
YWFSFDLGYTSPKLVLGGEINHYGPTETTIGAIA	asp
VETSFDGFTFDGFVLFGGEIHVYGPTETTVFATF	ile
LATHFDFSVWEGNQVFGGEVNMYGITETTVHVTH	thr
LDPSFDASTYEVFLWTGGEVDVYGPTETTTFATH	val
RWATFDLSVWELHFLCSGEHNLYGPTEAAIDVTA	ser
RWATFDVSVWELHFLCSGEHNLYGPTEAAIDVTA	ser
YDANFDLSVEEPHLNVTGDINTYGPTEATVSCTA	dab
VAWAFDVFSADRDFVCGSDVQAYGVTEASIDSTC	arg
LDNSFDASTPEGISMCGGEFNGYGPTEGTTCATS	phe
LATHFDFSVWEGNQVFGGEVNMYGITEITVHATY	thr
FVLAFDMSIKGSDSLLGGEYNMYGPTECTVDATI	asp
TALSFDLSVFDGNSLLSGDHVLGGATEAGIWSNL	cys
TDIAFDLSVYDGNSLWSGDVQPGRRTEAAIWSIE	cys
YWFAFDVSIAEGHFPIGGEHNFYGPTETVINASR	lys
LGTHFDFSVWEGNQIFGGEVNMYGITETCVHVSH	thr
AAWAFDVFSGDRESILGSDINSYGVTEATIDSSY	ORN
TWRFFDGCVTSTLITFAGEANEYGPTENSVATTI	tyr
LHQHFDFSVWEGNQIFGGEINMYGITETTVHVTY	thr
CSSAFDLSLFEAFLCLGGEISGYNPAECCPLGIS	ala
NPLCFDLLIVELGSMQAGEINAYGPAECSVGALA	phe
AYMSWDIPVTEVLWVFAGEVQGYGPAECSLISTV	pro
RWMTFDVSVWEWHFFCSGEHNLYGPTEAAVDVSW	ser
TAISFDLSVYDGNSMLSGDIAMGGATEASIWSNV	cys
LSLAFDASVKQADGLIGGETNVYGPTETCVDASV	gln
TETSFDAFMFDGMIMFGGELHMYGPSESTVFATY	leu
LWHAFDASIWEPFLLTGGDVNNYGPTENTVVATS	leu
FSMTFDISALELQALVGGETNLYGPTETTIWSAA	gly
LATHFDFSVWEGNQIFGGEINMYGITETTVHVSY	thr
TDISFDLSVYDGNSMLSGDIAMGGATEASIWSNA	cys
ADLAFEPFMRQINGLLVGEINEYAFTETAFVTAI	aad
FGLSFDFSVEQLSGLVAGEYNAYGTTETTVYNLV	val
QVTLFPFGCPGGSVQVGSAQQVFGMAEGLLTFTR	pip
AAYSFDISIADTVLIFTGEYNVYGPAENTLITTA	pro
GEHAFDASIGDTGICVAGEINMYGPTEATVACIA	ala
GCHSFDLSILEAFLGFIGEVNSYGPTEACVLVTA	ala
LNAGFDAGTFEGWLIIGGDWNGYGPTENTTFSTS	val
YWFSFDLGYTSPKLVLGGEINHYGPTEATIGAIA	asp
LHVSFDAFTFDAFALFGGEINCYGPTEGTVFATA	leu
LQTSFDASIWETLFYVGGDYNAYGPTENTVMSTL	leu
LQTSFDASVWETLLYIGGDFNAYGPTENTVMSTI	leu
LNSSFDASSWEAMLFAAGDFNAYGPTENTILSTI	val
LNSSFDISVQETMFFNVGDYNAYGPTENGMQSTM	gly
LQSSFDASIWETLFYIGGDYNAYGPTENTVMSTI	leu
LNSSFDASSWEAMLFAAGDYNAYGPTENTVLSTI	val
LQNSFDASVWETLLYIGGDYNAYGPTENSVMSTI	leu
LDSTFDVSLFEAIFYVAGDYNAYGPTENAILSTI	ala
LNSGFDAVTFEGFLYVGGEYNIYGPTENTTFSTF	ile
FWATFDLSVFEVNTNLAGEVNLYGPSETTTYSTY	phe
FTMTFDIAALELQALCGGEWNLYGPTETTVWSCR	gly
LSTHFDFSVWEGSQVLGGEINMYGITEATVHTTF	thr
LWQIFDYSVQESYALPGGEHNHYGPAESQLVTGY	pip
LSTHFDFSVWEGNQVFGGEVNMYGITETTVHVTH	thr
LDPAFDISLFEVHLLTGGDRHLYGPTETTLCATW	hpg
LDPAFDASLLEVHLLTGGDRHLYGPTETTLCATW	hpg
LAQAFDAAISEMTVIVAGEINGYGPTETTVCATM	bht
LNPAFDASLFEVHLLTGGDRHLYGPTETTLCATW	hpg
LAQAFDAMVSEMTVVVAGEVNAYGPTEATVCAAM	tyr
TDISFDLSVYDGNSLLSGDISLGGATEASIWSIG	cys
VSLAHDPSFRNLHTSCGGEVNVYGSTETCVGVSQ	glu
LDPAFDASLLEVHLLTGGDRELYGPTEVTLCATW	hpg
LAQAFDAAVSEMTVVVAGEINAYGPTETTVCATM	bht
FAMTFDISALELQALVGGETNLYGPTETTIWSTF	gly
FAMTFDISALELQALVGGETNLYGPTETTIWSTV	gly
LATHFDFSVWEGNQVFGGEINMYGITETTVHVSY	thr
LNNSFDASTLDAWMIVGGDLNGYGPTEATTFSTT	val
FWATFDLAVYEANTNVAGECNLYGPSETTTYSSW	ala
LDNSFDASSPEGFSECGGEFNGYGPTEATTCATR	tyr
LNNSFDASTLDAWMIVGGDLNGYGPTEATTFSAT	val
LGTAFDASTFEGWLLTGGDTICYGPTEGTVFTTA	val
LWHAFDAMAWEPFLLIGGDINNYGPTEATVVATS	leu
RWMTFDVSVWEWHFMCSGEHNLYGPTEAAVDVTA	ser
LNNSFDASTMDGFVLCGGEVHCYGPTETTTYATT	ile
MWGAFDSSVWEWKFLNGGGHNVYGPTETTVDSTG	asp
YGVSADLGHTLGKIMLGGEVNHYGPTETTVGILT	asp
RWMTFDVSVWEWHFVCSGEYNLYGPTEAAIDVTH	ser
LATHFDFSVWEGNQIFGGEINMYGITETTVHVTY	thr
RWMTFDVSVWEWHFMCSGEFNLYGPTEAAIDVTH	ser
LIFLFDGGFWEMAIVVAAERNSYGPTETTVCATM	trp
TEIAFDLSVYDGNSLLSGDTTLGGATEAAIWSNA	cys
NRTSFDASVLDWFFFCGGEHNLYGPTETSVDATC	leu
LVQAFDASIWEMTLVVAGEVNAYGPTESTVCATM	phe
TDISFDLSVYDGNTLLSGDVSLGGATEASIWSVY	cys
FGTSFDASVIDFAALTGADINGYGPTEGTCACAA	leu
LWCTFDLSVFDGNSFLSGDISLGGATEATVWSNW	cys
LAQAFDATVSEMTVVVAGEINAYGPTEATVCAAM	tyr
LEPAFDISLFEVHLLTGGDRHLYGPTETTLCATW	hpg
LDPAFDASLFEAHLLTGGDRHLYGPTETTLCGTW	hpg
LAQAFDAAISEMTVVVAGEINGYGPTETTVCVTM	bht
FAMTFDIAGLELQALVGGETQLYGPTETTIWSTI	gly
FAMTFDIAGLELQALIGGETQLYGPTETTIWSTI	gly
TYATFDVSVWELTCIVGGEYNAYGPTEVAVETTI	arg
LDYAFDAAVAEPTLLVAGEINAYGPTEATVAVTA	tyr
LAHAFDTIVSEMKAVAAGEINAYGPTETTICATM	bht
YHCSFDLTVTATKALLGGEVNEYGPTEATVGCVE	asn
YWASFDLTITSTKLIVGGDFNEYGPTETVVGCMI	asn
YWASFDLTVTSTKLIVGGECNEYGPTETVVGCMI	asn
LYEAFDVCYQESFLIAAGEHNHYGPSETHVVTMY	pro
YWASFDLTVTSTKLIVGGEFNEYGPTEAVVGCMI	asn
TYATFDVSVWESTCIVGGEYNAYGPTEVAVETTI	arg
LDPAFDASLFEVHLLTGGDRHLYGPTETTLCATW	hpg
LEPAFDISLFEVHVLTGGDRHLYGPTEVSLCATW	hpg
LETAFDISLFEVHVLTGGDRHLYGPTEVSLCATW	hpg
LAQAFDAAVSEMTVVVAGEINAYGPTETTVCASM	tyr
LESAFDISLFEVHVLTGGDRHLYGPTESTLCATW	hpg
LDRVFDVSMADPVMVSGGDHNEYGVTEATVVSTV	trp
SDLSFEPFVRQMNGVLVGELSEYGFTESAFVTAL	aad
LSLSFDHFVEQDSGDCVGEINGYGPTEVSITTSK	cys
LSLSFDFSLEQLSGTAAGENNAYGITETSVYNIV	val
AEIASPLALYEGHSLLGGEAHLSSATPSGPWTTC	cys
TCVSFDLAVYDGNSLLSGDMSLGGATEASIWSVW	cys
RWMTFDVSMWEWHFVCSGEYNLYGPTEAAVDVTA	ser
YWASFDLTVTAAKIVAGGEVNEYGPTETTVGCCA	asn
LACHFDFSVWEGSQVLGGEVNMYGITENTIHVTV	thr
FWATFDLSVFEANTNLAGERNLYGPSEATTYATA	ala
SARSFDSSVAGWLAIAAGEHNEYGPTETTVWSTV	asn
VQTTHDMSVFDAVSAQGGDISLGGPTETTIWSIW	thr
LWQAFDVAFQESYMITAGEHNHYGPTESHVVTAL	pro
LDNSFDASTLDAWLIVGGDLNGYGPTEATTFSTT	val
TDIAFDLSVYDGNSLWSGDFSLGGATEAAIWSIE	cys
RWMAFDVSVWEWHFFSGGEHNRYGPTETAINVTH	tyr
LNTAFDAATFEGFLLFGGELHVYGPTENTTFSSW	ile
HWMTFDASVWEAQLFCGGEHNLYGPTETCIDATF	gln
LWQVFDYSVQESYACQGGEHNHYGPAESQLITGY	pip
LSAAFDVSLLEMLLVMAGEFNGYGPTEATVLATI	pro
RWGTFDVSVWEWHFFCSGEHNLYGPTEAAIEVTH	ser
LWHTFDVSAQESFAAQAGEHNHYGPTETHVVTAH	pro
FAMTFDIAALEHQGLVGGEVNLYGPTETTIWSTA	gly
LDPSFDASTYEVWLWTGGEVDGYGPTETTTFATH	val
LAQAFDASISEMTLIVAGEFNAYGPTEASVCATI	tyr
LWQAFDVSFQETFVITAGEHNHYGPSESHVIITF	pro
LWHAFDAAVWEPFLLTGGDVNNYGPTENTVVSTS	leu
FSMTFDIAALELQALCGGEWNLYGPTETTIWSSI	gly
YWASFDATITSLKIVLGGEINEYGPTEAVVGCCV	asn
RWMTFDVSVWEWHFICSGEHNLYGPTEAAIDVTY	ser
LWHAFDVSFQETFLITAGEHNHYGPSESHLATSF	pro
LWHAFDAAVWEPFLLTGGDVNNYGPTENTVVTTS	leu
TDMSFDLSVYDGNSLMSGDVSLGGATEASIWSIL	cys
LNTHFDFAVWEGNQIFGGEVNMYGITETTVHVTH	thr
LVLHFDASVWENTQAVVGEINAYGPTETTICVTS	phe
LTLHFDYSVWEGSQVFGGEINMYGITETTVHASF	thr
LALHFDVSVWEGCQIVAGEINAYGPTEATIYAAM	ala
TYNTFDVSVWESTCIVGGEYNAYGPTEVAVDATV	arg
LWHAFDAAVWEPFLLTGGDINNYGPTENSVVTTS	leu
RWMTFDVSVWEWHFFCSGEHNLYGPTEAAIDVTY	ser
LWSTFDLSVFELNTNLAGEYNLYGPSEDTTYSTF	ala
VSLAHDPSIRNLHTSVGGEINVYGSTETCVGVSQ	glu
TYNTFDVSVWELTCIVGGEYNAYGPTEVAVETTI	arg
LWHAFDAAVWEPFLLTGGDINNYGPTENTVVTTS	leu
LWSTFDLSVFELNTNFAGEYNLYGPSEDTTYSTF	ala
YRASFDLTITATKAILGGEINAYGPTESTVNITD	asp
FDMTFDIAGLELQALVGGETNLYGPTEATIWATA	gly
YVSSFDLTVTGAKAVLGGELNEYGPTETIVGCTT	asn
RWMTFDVSVWEWHFFCSGEHNLYGPTEAAVDVTY	ser
LATHFDFSVWEGNQVFGGEVNMYGITETTVHVSH	thr
LIFLFDASFWEMSLVVGAELNSYGPTETTVCSTM	trp
LDHAFDVSCYEVHLLTGGDRHLYGPTETTLCVTQ	hpg
FCMTFDIAALELQALCGGEWNMFGPTETTIWSTM	gly
NAIMHDMGLIAPSSANGAELNVYGLAEASVGATF	glu
VALAFDGSVVEMQLMVAGELNGYGPTETTVGAAM	phe
LALSFDGSISEMTLIVTGEVNAYGPTEITVAATA	tyr
FWMPFDISHFYVFGVFCGEYNTYGPTEATVAVTS	ala
YGVSADLGHTAGKIVLGGELNHYGPTETTVGVLT	asp
ASILFGYGLNQSALTAAAAFCMYGQTECTRISFL	phe
FWLNFDASQYELVSISCGEVNTYGPTECTVAVTA	ala
TDISFDLSVYDANALLSGDISLGGATECAIWSVY	glu
CTVTFDISVLELQALCGGEWNVYGPTETTIWSTF	phe
VCHAFDVAQLESFVFTAGEVDCYGPAEATIFATC	aad
FVAMFDFSVEEVCVLVSGELNVYGPTEATVTATW	phe
FWSAFDLSVFDVYSIFAGEYNFYGPTETNVSTYY	phe
VETTHDMSVFDAVSAQGGDFSLGGPTETTIWSIW	phe
FWEVFDVSVMSPVSLLCGEFNTYGPTETTVAITQ	ala
LSFTFDIFFVELQTVLGGEFNGYGPTETTIYVTV	phe
IHTSFDGFTFDGFVLFGGEIHVYGPTEVTVFATA	ile
LWMTFDVSLYDGVSLFCGELNTYGPTEATVATTL	ala
FWSAFDLSVMDTVSLFCGEINTYGPTESTVAVTG	ala
FWEAFDLSVMDPVSLFCGEFNTYGPTETTVAISG	ala
RWMTFDVSVWEWHFIVSGEHNLYGPTEAAIDVTH	phe
YGVAADLGYTAGKIVTGGEFNHYGPTETTVGVIA	asp
NELSFDPYYIEFQIMFGGEYNLYGITEISCWSFM	phe
FWEPFDLSVMDPVSLFCGEFNTYGPTEATVAVSA	ala
FWGAFDLSVMDLVSMFCGEINSYGPTEATVAVTA	ala
FWIAFDLSVTSPVSIFVGEVNGYGPTEATVAVSA	ala
YWSAFDLSVMDTVSLFCGEINTYGPTESTVAVTD	ala
FWAAFDLSVMDPTSLFCGEMNTYGPTEATVAVTA	ala
YSVSADLGNTMPKIVLGGEFNHYGPTETTVGVLW	phe
FWIAFDASVPDIVWIFCGEVNMYGPTEATYACMY	ala
FCFAFDVSVKDSIWMFSGEVNLFGPTEITCNCSY	phe
MNLAFDASILESTLAVVGEINGYGPTENTVMSTV	phe
FWYAFDMGIMDPFSFVAGERHAYGPTETTCVTHS	ala
FWMPFDLSVMDPVSFFCGEYNTYGPTEATVAVTS	ala
FWIPFDLSVMDPVSLFCGEFNTYGPTETTVAISQ	ala
FWTTFDLSIFETNTNLAGEYNLYGPSEDTTYSTA	phe
LWMSFDASVLDPFLLTGGEYNLYGPTECTVLVAF	phe
FWQPFDLSVMDAVSLFCGEFNTYGPTESTVAVSA	ala
FRQAFDAAVIDVLLAIGGEINSYGPTETTVAVTN	phe
FWVAFDLSVMAPVSLFCGEYNTYGPTEATVAITS	ala
FWAAFDLSVMSPVSLFCGEYNTYGPTEATVAVSQ	ala
RWMTFDVSVWEWHFFASGEINLYGPTEATVDVSF	phe
FAELFDASCEELSTILGGEWNTYGPTEATVVATA	phe
FWMPFDLSVMYPISYFDGEINAYGPTEATVALSA	ala
FWTAFDLSVMGPISLFCGEYNTYGPTEATVAVSG	ala
FWMAFDLSIFSPVSIFCGEWNTYGPTEATGAITS	ala
RWQTFVDSICEGVLVCSGECNFYGSTEIMGDVSY	phe
FWMPFDLSVMSPVSLFCGEFNTYGPTESTVAITE	ala
FWKAFDLSVMSPVSLFCGEFNTYGPTETTVAVTQ	ala
RWMTFDVSVWEWHFICSGEVNLYGPTEAAIDVSC	orn
LFLSFDGAMKDLLWSFAGEVNLYGPSETTVDCAY	ala
LSTHFDFSVWEGNQILAGEFNGYGITETTVFVSF	phe
YWMAFDLSVMAPVSLFCGEFNTYGPTETTVAVTQ	ala
YAFSFDIFVEEASGISGGDYNTYGPSEITVCASY	glu
YSKSFDMAIAQILGCSGGEVDCYGPTEISCCATM	phe
FWAAFDLSVMNPVSVFCGEFNTYGPTEATVAMTS	ala
YWMAFDLSVMHPTSYFDGEINAYGPTEATVALSA	ala
YWIAFDLSVMDRVSLFCGEFNTYGPTETTVCVTA	ala
GIVLFDYGLNQTAGTNSGGYLMYGLTEAFRSTFL	phe
MTQAFDATVWEMTLVVAGEFNAYGPTESTVCASI	phe
LNDHFDFSVWEGNQIFGGEINMYGITETTVHVTY	thr
TQLTFDFSVPECNLFACGEENIYGPTEAAVYATR	ala
TAYAFDVFVGDRESITSSDINSYGVTEAAIDSSF	dab
TGYAFDVFVGDRESITSSDINSYGVTEAAIDSSF	dab
TGYAFDVFVGDRESITSSDINAYGVTEAAIDSSF	dab
LDQIFDVFVSEMSLIVGGEVNAYGPTETTVEATA	trp
FYSSFDLTVTSPKALVGGEFNDYGPTEATVNCVD	asn
YRGHFDLTVTVTKALLGGEINAYGPTELTVNCAE	asp
LACHFDFSVWEGSQVFGGEVNMYGITETTVHVTV	thr
FDATFDIAGLEAQALVGGETNVYGPTEATIWATA	gly
LEQAFDVAVAEMLAVTGGEFNVYGPTEATVQATS	trp
FRASFDLTVVTGKAVLAGELNSYGPTETTVNCLE	glu
HRSSFDLTVTATKGVLGGEFNDYGPSETSVNCSD	asn
LACHFDFSVWEGSQVFGGEVNMYGITETTVHVTH	thr
RWMTFDVSVWEWHFFSSGEHNLYGPTEAAVDVTW	ser
LSTHFDVSVWEGNQVFAGEVNMYGITETTVHSSF	ser
YWHVFDVAVGEPYLLVIGDLNAYGPAEATVAATQ	gly
IEAYFDGGVWELTLGLAGDFNIYGPSEATLSVAL	phe
RWMTFDVSLWEWHFLCSGEHNLYGPTEASIDVTA	ser
YWASFDLTVTTAKVVMGGEFNEYGPTETVVGCAV	asn
LTTHFDFSVWEGNQIFGGEINMYGITETTVHVTY	thr
IVSAFDASVWEALLISGGEFNAYGPTETTIYATL	leu
YWASFDLAVTGVKVVVGGEVNHYGPTETTVGCCV	asp
LATHFDFSVWEGSQVFGGEVNMYGITETTVHVTH	thr
YWASFDFTLTNCKLIVGGEYNEYGPTEATVGCIV	asn
RWMTFDVSVWEWHFVCSGEYNLYGPTEAAVDVTA	ser
LGHAFDASWDPWDVVVGGEVNLYGPTETTVDAYY	arg
LATHFDFSVWEGNQVFGGEVNMYGITETTVHVSY	thr
TDISFDLSVYDGNSLLSGDVSLGGATEASIWSIY	cys
FSMTFDIAALELQALCGGEWNMFGPTETTIWSAV	gly
LEPGFDASTLEGWMLVGGDINGYGPTENTTFSTT	val
RWMTFDVSVWEWHFFFSGEHNLYGPTEAAVDVSF	ser
LSTHFDFSVWEGNQIFGGEVNMYGITETTVHVSY	thr
RWMTFDVSVWELHFFTSGEHNLYGPTEAAVDVTY	ser
LAQAFDASISEMTLIVAGEFNAYGPTEATVCATI	tyr
TDISFDLSVYDGNSMMSGDISLGGATEGSVWSIL	cys
VHFTFDISALELQAVCGGELNVYGPSETTIWSTS	gly
FAMTFDIAGLELQALCGGEWNMYGPTETTIWSSV	gly
TAITFDISVLEMQALCGGEWNVYGPTEATIWSTI	gly
AWTSHDFSVYDGSTMLGGDVSVGGPTETSLWNIT	thr
FSMTFDIAGLELQALCGGEWNMYGPTETTIWSMV	gly
LSQAFDASASETTIVAAGEVNAYGPTESTIGATF	tyr
TDISFDLSVFDSNSMMSGDLSLGGATEAAIWSIA	cys
YWASFDLTVTSTKVIVGGEINEYGPTETVVGCMI	asn
LWQAFDICYQETYLITAGEHNQYGPSECHVVTSH	pip
FSMTFDIAGLELQALCGGEWNLYGPTETTIWSTV	gly
LWHAFDASVWEPFILTGGDVNNYGPTENTVVTTS	leu
AGWAFDVFAGDREFVVGSDINSYGLSEATIDSTY	orn
LWQAFDISLQESFVSQAGEHNHYGPSEAHVVTSY	pip
LHSSFDASVWELVLLSAGDYNGYGPTENGIQSTI	phe
VSPTFDVSLWETVFFSSGDHNAYGPTENGIQSTI	pro
LQSSFDASAWEAMLYLGGDINAYGPTENSVISTT	leu
YAKSFDMGLAQNLACLGGEQDSYGVTEISACTTF	trp
LSDFFDGATYETIMISGGDYNGYGPTENGVFSTV	leu
GSYAFDVCMVDTALLLVGEYNVYGPAENNLITTA	pip
GELAFDASIGDCGICFSGEVNMYGPTEATVACIA	ile
SSHAFDPSLMEVMAWSMGEVNAYGPTEGAINCTY	aad
SSLSFDVSIQDYHLTMIGEFNTYGPAEATVVSTI	cys
FSIAFDPHLLEFSFTVGGEVNAYGPTEVTIGCTF	val
SAHAFDVSIMESFLVMGGEMNEYGIAECSVASTI	trp
GSHAFDVSIMESFMIVGGEMNAYGPAECSVNVSV	trp
SHHSFDVSIYETFLVLGGEINGYGPAEATICGVG	pro
HLKSFDMSIIQSIACLGGETNCYGPTEITAAATF	trp
HLKSFDMSLVQCIACMGGETNCYGPTETTAAISF	tyr
PGVSFDAAVYQITHMVAGEINAYGPTEASICSSL	phe
HAKSFDMSVVQCIACMGGETNCYGPTEITAAATF	tyr
QGFSFDFSLEQVSGFFGGEFNNYGPSETTIACTH	ser
QWLTFDAAQWESQCFSGGEINLYGPTECTINNSA	gln
LAQAFDACISEMTLIVAGEFNAYGPTEGSVCATL	tyr
LTQSFDASFWEMTLVVAGEVNAYGPTESTVCATM	phe
LSHSFDGAFWDMTLVNVGEVNAYGPTESTVSATM	trp
LSLAFDASVSEGMLEFCGEFNAYGPTEATVCFSL	phe
RCMAFDVSVWEWHFFSGGKHNRYGPTETAINVTH	ser
HAVYFDASTE-RGFITGGEFNAYGPTETVVMPLA	phe
NSKAFDISVWQAESLPTGEVNAYGPAECSDDVAF	dab
HAVYFDAATERVGFITGGEFNAYGPTETVVMPLA	phe
LALAFDVFMSDREFTCGADVSVYGVTEATCESAT	lys
YTLSFDVSVREWHFMTSGERNMYGPTETTVEMTD	ser
YQVFFDACLGVSPLFLGGEFNCYGPTETTCTSLI	tyr
LFPLFDCCVNEAMCALAGELNVYSPSECTISTVY	ser
LDHAFDTSWEGIDVMLGGEYNYYGPTEFTVDALA	orn
YRGSFDLTVTVTKVLVGGEVNAYGPTELTVNCAE	asp
FWATFDVSVVEASGALAGEANFYGPTEATVYATA	ala
FDMTFDIAALEVQAVVGGETNMYGPTETTIWSTS	gly
RWMTFDVSVWEWHFICSGEHNLYGPTEAAVDVTH	ser
YRTSFDLTVGAAKATLGGEFNVYGPTETTINCAE	glu
LWATFDVSVFDVNALCAGEANLYGPTETTVFVTA	ala
YGASFDLSATATKAVLGGEVNAYGPTELTVNCAE	asp
LAHSFDASWDPADLALGGEMNTYGPTETAVDAVV	lys
YGATFDLTVTTTKAILGGEVNAYGPTELTVNCTE	asp
FDMTFDIAVLEAQALVGGELNLYGPTETTVWSTV	gly
FRSGFDLTVTTTKVVVGGEFNDYGPTEATVSCAD	asn
YRGSFDLTVGAVKVTFGGEYNVYGPTETTVNCSE	glu
LAQAFDGAVLEMFIVVGGELNIYGPTETTAVTLT	ile
EWMALNASGWEWHVMCSGEHSLYGPVEAMPVVTS	cys
FSMTFDIAALELQALTGGEINLYGPTETTVWSTL	gly
LWCTFDLSVFDGNSFFSGDISLGGATEATVWSNF	cys
LDPAFDASTYEVWLWAGGDVNGYGPTETTTFAAR	cys
CASSFDISIFEAFLCLGGEVTGYNPAESCPLGIS	ala
NHLAFDAMIVEIMLVQAGEFNAYGPTECSVISTT	val
AHLSWDIPVTDLLLVLAGEIQGYGPAECSLVSTV	pro
SAWAFDLFIGDRDFVCGADLGSYGVTEATIDSSV	thr
NAMVFDVVLGEPWIIVAGELNGYGPTECAIVVSL	lys
HMKAFDISLWQAQISVTGEVNAYGATEVSDDTMH	asn
FTCSFDLTVTVTKAVLGGEFNDYGPTETTVNCAD	dab
LWHLFDFAVQEQFAFQGGEHNVYGPAETHAVTTA	pip
YWASFDLTVTATKGMLGGELNVYGATEATVNSVQ	asp
YRGSFDLTVTATKVVTGGEVNAYGPTEATVNCTD	asp
FDMTFDIAGLEVQALVGGETNLYGPTETTVWSTV	gly
LARSFDASTFETFVWAGGDANEYGPTETTVFSTV	dab
LDSSFDASAYEVWLWTGGDVDGYGPTETTTFAVR	val
LWHTFDVSVQESYAVQAGEHNHYGPAETHVVTAY	pro
LHHAFDVSYHEAILITAGEYNFYGPSEADLVTAY	pro
TAVSFDLGVYDGNSLLSGDIGMGGATEASIWSVW	cys
LDPSFDASTFEAWLLAGGDVNGYGPTENTTFTCL	val
YWASFDFTLTAAKLVLGGEFNEYGPTETVVGSTA	asn
LWCTFDLSVFDGDSFLSGDVSLGGATEATVWSNY	cys
LDGSFDASTYEVWLWAGGDVNGYGPTETTTFAAR	val
RWMTFDVSVWEWHFICSGEYNLYGPTEAAVDVTE	ser
LGMAFDIAALELQAITSGETNLYGPTEATIYSTA	gly
LSQAFDAAFWDLTLVSTGDLNGYGPTEVTVGISI	trp
TDIAFDLSVYDGNSLLSGDISLGGATEGSIWSVC	cys
LRGFFDGATYELIMMVAGDYNAYGPTENGVMSTL	phe
TWRPFDSSVEDTLATVAGEFNEYGPTENSVCSTR	his
FGAAFDASVEELDLIIGGELNTYGPTEATVVATT	lys
MNHVFDMSWEEWNVLLGGEYNLYGPTEYTINTLG	hrn
RCLTFDTSVWEWDFTVGGEHNLYGPTEAAVDVLG	hrn
LTAAFDVAVWEMALLVGTEVVAYGLTEATVNSTL	han
LTAAFDVAVFEMALLVGTEVVAYGLTEATVNSTL	han
HC-PFDASVMDAHSVLGGELNGLGPTECTTALQY	glu
NNKAFDVSVWQIEVMVNGEINAYGPTEASDDITH	dap
LGITFDIFVLELQMMLGGEYNMYGPTETTVWSSI	gly
RGFSFDASIEELSLIIGGELNTYGPTENTVIATY	lys
FWATFDLSIFEVNSNLAGECNLYGPSETTTYSAW	ala
FSTAFDVSVFESDLFVGGEFNGYGPTECTVTMIV	val
MAWSVDLFFSDLVTMVGSEVNAYGSTETTVDSTV	bnd
AAWSFDASIMDVVTLLGGEINVYGQTETTVACTM	adh
LTVAFDVAIWETTLHIGGEINGYGATETTVAATL	dmw
FTLSVDASVLEWHISVGAEVNAYGPTECTVAASH	leu
LGHAFDASWDP-DVVVGGEVNLYGPTETTVDAYY	arg
YWKPFDSSVADPTTTVAGEINEYGPTECSVGATA	his
TWRPFDSSVADCLITVAGEFNEYGPSENAVCSTV	his
SARSFDSSVALGLCIVAGEYNEYGPTEGTVWASV	his
SARSFDSSVAGGLCIVAGEYNEYGPTEATVWATV	his
HWMTFDASVWEAQLFCGGEHNLYGPTEACIDATF	gln
LWSTFDASVWEWQFVCGGGHNVYGPTETTVDSSA	gln
LWSTFDASVWEWQFVCGGGHNVYGPTETTVDCSV	gln
HWITFDASVWEAQVFAGGEVNLYGPTETTIDATY	gln
MNHVFDMSWEE-NVLLGGEYNLYGPTEYTINTLG	hrn
QALAFDMSVEEGNLMIGGEFNAYGPTEATVNASI	orn
LTVAFDASVIEMMILVGAEVNGYGPTEATIATSF	orn
LSHWFDASWQP-ELGVGGEYNLYGPTECTVDSAA	hrn
MTAAFDSSVGEYFISTGGELNAYGPTETTVDATV	orn
LNHAFDTSWEG-DLMLGGEYNFYGPTEATVDTLW	orn
LTAAFDVTVWEMALLVGTEVVAYGLTEATVNSTL	orn
LTAAFDVFVFEMILLVGTEICAYGLTEATVNSTL	orn
FDMTFDISALELQAFVGGEHNVYGPTETTIWSTA	gly
FAMTFDIAALELQALCGGEWNLYGPTEATIWSSI	gly
FSMTFDIAALELQA-IGGEWNMYGPTETTVWSMI	gly
FGITFDISLLEGQALCGGEWNCYGPTEATVWSLV	gly
ASFTFDIAMLELQGWCGGEWNLYGPTETTIWSAA	gly
LWATFDVSVFEPSGALCGEANIYGPTEATVYATA	gly
FSMTFDIAVLELQALVGGETNLYGPTETTVWSGA	gly
SRSLFPLSSPGGSLQVGGAQQVFGMAEGLVNYTR	gly
SARSFDSSVPAWVLICAGEANEYGPTETTVWSSL	his
LAHAFDASLDP-DLGPGADYNFYGPTECTVDSVV	lys
QWTYFDPSLLETDLFSGGEFNVYGPTEATVQVTS	arg
MSLSFDAHLMEPMLAIGGEFNCYGPTEDSVCATV	leu
MGLAFDAHVFEIILLVGGEFNAYGPTEASVCATM	leu
LAHAFDVSIADQMIATGGEFNAYGPTEATVTVTL	leu
LTMAFDTSVWEMTLIVAGEFNSYGPTETTVDATL	his
CWMAFDVSVWEWNFICGGEQNLYGPTETTIHVTH	arg
SSYAFDAFVCDTSMTMGGECNVYGPAETAINTTI	gln
HWMTFDASVWEAQLCVGGEWNLYGPTEATIDALA	gln
LWSTFDASVWEWQFFCGGGHNVYGPTEATVDSTV	gln
HWQTFDASVWETQFFSGGEVNLYGPTEATIDSTS	gln
LWHAFDAMAWEPFLLIGGDVNNYGPTEATIVATS	gln
YWSSFDATITCTKLVIGGEINEYGPTETVVGCSI	gln
HWFTFDASVDEAVVFSGGEVNIYGPAETTVESVY	gln
LGLAFDASVQQ-DCLLGGELNVYGPTECTVDTTS	gln
ATHAFDAVLQDTNLILAGELNVYGPTECSINSTC	gln
RRLT-DGSVDGAYSVCRGEHNLYGLIEAGAGITT	thr
LAMAFDIAVLELQAISTGETNLYGPTEATVYSSA	ala
SVSLYPMSSPGGALQVGGAQQVFGMAEGLVNYTR	dhb
SASLFPLSSPGGALQVGGAQQVFGMAEGLVNYTR	dhb
GRFVFGASAT-GLGVSGGSISLYGSADGVNCHNA	dhb
NASLFTLACPGGALQVGGAQQVFGMAEGLLCYTR	dhb
NASLFPLACPGGALQVGGAQQVFGMAEGLLNYTR	dhb
SASLFPMSSPGGAAQVGGAQQVFGMAEGLVNYTR	dhb
SASLYPMSSPGGALQVGGAQQVFGMAEGLVNYTR	dhb
SRSIYAMSSPGGALQVGGAQQVFGMAEGLVNYTR	dhb
SASLFTLSSPGGALQVGGAQQVFGMAEGLVNYTR	dhb
SASLFMLSSPGGSLQVGGAQQVFGMAEGLVNYTR	dhb
NAVTHNLNMGCGGVVA---HHIFGMTEGVIMFAR	dhb
SKSLYPLSSPGGAVQVGGAQQVFGMAEGLVNYTR	dhb
SASLFPLSSPGGALQVGGAQQVFGMAEGLVCYTR	dhb
SRSLYAMSSPGGSLQVGGAQQVFGMAEGLVNYTR	dhb
SESLYALSSPGGALQVGGAQQVFGMAEGLVNYTR	dhb
SESLFPMSSPGGAAQVGGAQQVFGMAEGLVNYTR	dhb
VETLFPLCCPGGGLQVGGSQQIFGIAEGLIMTTS	dhb
VYSLFPLGCPGGGLQIGGSQQIFGIAEGLISTTS	dhb
NCCLFTLGCPGGALQVGGSQQVFGMAEGLICCTR	dhb
SASLFPMSSPGGSLGVGGAQQVFGMAEGLVNYTR	dhb
NASLFPLACPGGALQAGGAQQVFGMAEGLLCFTR	dhb
SRSMFTMSSPGGALWVGGAQQVFGMAEGLVNYTE	dhb
SRSLFPLSSPGGALQVGGAQQVFGMAEGLVNYTR	dhb
NKALYPLANPGGSVLIGAAQQGYGLGEGITCFTQ	dhb
LELLFALCCPGGALQIGGSLQLYGMSESLITCSR	dhb
SESLFPLSSPGGGVLVGGAQQVFGMAEGLVCYTR	dhb
NCCLFTLGCPGGALQVGGSQQVFGMAEGLIACTR	dhb
SGSLFPLSSPGGALLVGGAQQVFGMAEGLVNYTR	dhb
SRSLYPLSSPGGALQVGGAQQVFGMAEGLVNYTR	dhb
VQCLFPLGCPGGALQVGGAQQVYGIAEGLICMTD	dhb
SKCMFHICGPGGALQLGGAQQIYGMGEGLVYATY	dhb
NMSLFPLCCPGGALQVGGAMQVFGTAEGLLSFTS	dhb
NQWLHNAGIVCHLMAWA-DIQMFGMGEG--MCMF	dhb
GGLFHIGGAVMAGTLAGGAANAWGLTEFPVAASP	dhb
SASLFPMSSPGGSLQVGGAQQVFGMAEGLVNYTR	dhb
SASLFPMSSPGGGLLVGGAQQVFGMAEGLVNYTR	dhb
SGSLFTMSSPGGSLQVGGSQQVFGMAEGLVNYTR	dhb
SRSLYAMSSPGGSLQVGGAQQVFGMAEGLVNYTA	dhb
SGSLFPLSSPGGALQVGGAQQVYGMAEGLVNYTR	dhb
QATLFTWGCPGGSLQLGGAQQVFGMAEGLLTLTR	dhb
SESLFPMSSPGGSLQVGGAQQVFGMAEGLVNYTR	dhb
SGSLFPLSSPGGAVQVGGAQQVFGMAEGLVNYTR	dhb
NACVFLLSSPGGALQVGGAQQVFGMAEGLINYTR	dhb
NAVTHNLNMGCGGVFIA--HHIFGMTEGVIMFTR	dhb
NQSLYTLASFGGASQNGGAQEVYGTAEGLLNYTR	dhb
SASLFPLSSPGGAMQVGGAQQVFGMAEGLVNYTR	dhb
NAVQHNLNMGCGMLIAANSFHIFGITEGVIMFTH	dhb
NACLFTLCCPGGALQVGGAQQVFGMAEGLICCTR	dhb
HAWA---HLYAPVSFC----NMYGTTEGLLIGSG	dhb
SCALFTLSSPGGALWVGGAQQVFGMAEGLVNFTP	dhb
SKSLFCMSSPGGSLQVGGAQQVYGMAEGLVNFTH	dhb
SESLFSMSSAGGCLQVGGAQQVFGMAEGLVNYTR	dhb
SKSLFTMSSPGGSLQVGGAQQVFGMAEGLVNYTR	dhb
SASLYPMSSPASALQVGGAQQVFGMAEGLVNYTR	dhb
SASLFPMSSPGGALQVGGAQQVFGMAEGLVNYTR	dhb
NQCLFTLGCPGGALQVGGSQQVFGMAEGLIACTR	dhb
TESLFPMSSPGSALQVGGAQQVFGMAEGLVNYTR	dhb
NASLFPLACPGGAVQVGGAQQVFGMAEGLLNFTR	dhb
NEYIHNAGVVCALLVLSGAWQLFGMGEGLFLTTR	dhb
SRSLYTMSSPGGPLQVGGAQQVFGMAEGLVNYTR	dhb
SASIYPMSSPGGPLQVGGAQQVFGMAEGLVNYTR	dhb
SMSLFPLSSPGGAVQVGGAQQVYGMAEGLVNYTR	dhb
STSLYPMSSPGGALQVGGAQQVFGMAEGLVNYTR	dhb
SESLFPMSSPGGGLLVGGAQQVFGMAEGLVNYTR	dhb
YSLMHNAGVIGGLLLFSGK-QIFGMSEGLCLTTP	dhb
SGSLFPLSSPGGALQVGGAQQVFGMAEGLVNYTR	dhb
SESLFPMSSPGGGLQVGGAQQVFGMAEGLVNYTR	dhb
SRSLYPMSSPGGSLQVGGAQQVLGMAEGLVNYTR	dhb
SGSLYPLSSPGGALQVGGAQQVFGMAEGLVNYTR	dhb
SRSIFAASSPGGAAQVGGAQQVFGMAEGLVCYTR	dhb
LDSAFDPSLYAVHLGTGGDRNTYGPTETTLCATW	dpg
LDAAFDPSLYEVHLGTGGDRNTYGPTETTLCATW	dpg
LDPAFDASLYDVNFLAGGDWHTYGPTETTLCATW	dpg
LDEAFDPSLYAVHLGTGGDRNTYGPTETTLCATW	dpg
LDAAFDASLYEVHLGTGGDRNTYGPTETTLCATW	dpg
LDAAFDPSLYAVHLGTGGDRNTYGPTETTLCATW	dpg
LAHAFDVSIADQMIATGGEFNAYGPTEATVTATL	crp
VHTAFDAATFEGWLLAGGDINGYGPTETTTFAAA	ile
VDPAFDAGTLESWIMSGGDINGYGPTEGTVFTSL	val
LAVTFDASLIEMLILVGAEINGYGPTEATIATTF	mha
LDTSFDAATYEAFLWTGGEVHVYGPTETTTFAIC	ile
GSWAFDVFVSDHDTAGGADVNGYGVTEATVESCV	lys
RWWAFDIAVWEAHFVCGGEVHAYGPTETTITVVH	hpg
HWACFDVLVEEPNLVIGGQVNAYGPTEMTIGATA	arg
QWSAFDISLWEHHLVCGGENHTYGPTEASIIVTH	hpg
RWMTFDVSVWELHFISSGEHNLYGPTEATIDVTH	ser
RWSAFDIALWEFHFLSGGEHQAYGPAEASISVTH	hpg
